%%%%
%.G%
% P%
%  %           
%%%%